[ molecule ]
LIG LAC

[ martini ]
ALC1 CAC1

[ atoms ]
1    C1   ALC1
2    C2   ALC1
3    O1   ALC1
4    C3   CAC1
5    O2   CAC1
6    O3   CAC1
7    H1   ALC1
8    H2   ALC1
9    H3   ALC1
10   H4   ALC1
11   H5   ALC1
